4,4,11,11,11,11,11,11,11,11,11,4,4,4,4,4,4,4
4,4,4,11,11,11,11,4,4,4,4,4,4,4,4,4,4,4
4,4,4,4,11,4,4,4,2,2,2,4,4,4,4,4,4,4
4,4,4,4,4,4,4,4,2,2,2,4,4,4,4,4,4,4
4,4,4,4,4,4,4,4,2,2,2,4,4,4,4,4,4,4
4,4,4,4,4,4,4,4,4,4,4,4,4,4,4,4,4,4
4,4,4,2,2,4,4,4,4,4,4,4,4,4,4,4,4,4
4,4,4,2,2,4,4,4,4,4,11,4,4,4,4,4,4,4
4,4,4,2,2,4,4,4,4,11,11,11,4,4,4,4,4,4
4,4,4,2,2,4,4,4,11,11,11,11,11,11,4,4,4,4
